# #############################################################
#   #     # #   # #             #     #           #     #     #
# ### # # # # # # # ####### # ### # # ########### # # ### ### #
#     # # #   # #   # #   # # #   # # #           # # #     # #
# ####### ### # # ### # # # ### ##### # ######### # ### ### # #
# #   #   #   # #     # #   #   #   # #   #   #     #   # # # #
# # # # ### ### ##### # ##### ### # # ### # # # ##### # # # ###
# # # #   #   # #   # # #     #   # #   # # # #     # # #     #
# # # ### ##### # ### # # # ### ### ### # # # ##### # # ##### #
#   # # #       #   # # # #   #   #   # #   #   # #   # #   # #
##### # ########### # # ##### ### ### # ####### # ##### # ### #
#   # #   # #     #   # #     #     # #       # #   #   #     #
# # # ### # # # # ##### # ##### ### # # ##### # ### # ####### #
# # #     # # # #     #   #   # #   # #   #   #   #   #   #   #
# # ### ### # # ##### ##### # # # ### ### # ##### ##### # # ###
# # # #     # #   #   #     # # #   #     #   #         # #   #
# # # # ##### ### # ### ####### ############# # ######### #####
# # # #     # # # # #   #       #   #       # #       # #     #
# # # ##### # # # # # # # ####### # # # ### # ####### # ##### #
# # # #       #   #   # # #   #   #   # #   #       # # #     #
# # # # ########### ### # # # # ######### ######### # # # #####
# # #   #   #   #   #     # # # #   #   #     #   #   #   #   #
### ##### ### # # ### ##### # # # ### # ##### # # ##### ### # #
#       # #   # #   #   #   #   # #   # #   #   #       #   # #
# ##### # # ### ### ##### ####### # ### # ########### # ##### #
# #   # #   #   # #     # #   #   #   #   #     #   # # #     #
# ### # # ### ### ##### # # # # ######### # ##### # # ### ### #
#   #   # #   #     #   # # #   #     #   #   #   # # #   #   #
# # ##### # ##### # ##### # ##### ### # ##### # ### # # ##### #
# #       #     # #   #   #     #   #   #     # #   # # #   # #
# ############# # # # ### ### # ### ##### ##### # ### # # # ###
#   #           # # #   #   # #     #           # # #     #   #
# # ############# ##### ### ####### ############# # ######### #
# # #   #   #   #     #   #           #   #     # #           #
# # # # # # # # ##### ### ########### # # ### # # # ######### #
# #   #   # # #   #   #           # # # # #   #   # #   #     #
# ######### # ### # ### ##### ### # # ### # ### ##### # # #####
#     #     # #   #   #   #   #     #     # #   # #   # #     #
##### # ##### # ####### ### ### ######### # # ### # ### # #####
#     #     # #       # #     # #       # # #   #   #   # #   #
# ####### # # ####### ### ### # ####### # # ##### ### ### # # #
# #     # # #     #   #   #   #         # #       # # #   # # #
### # # ### ##### # ### ####### ######### ##### # # # # # # # #
#   # #     #   # #   #     #   #   #   #   #   # #   # #   # #
# # ######### # # ### ##### # ### # # # ### ######### #########
# #   #       #   #   #   # # #   #   # # #   #     #         #
# ### # ########### ### # # # ### # ### # ### # # # ######### #
# # #   #     #   #     #   #     #   #   #   # # #     # #   #
# # ##### ### # # ### ################# ### # # # ##### # # ###
# #     #   # # #   #   #     #     #   #   #   # #   #   #   #
# ##### ### # # ### ### # ### ##### # ### ######### ### ##### #
#   # # #   # #   #   # #   #     #   #       #   #   # #   # #
# # # # # ### ### ##### ### ### # ##### ####### # ### # # # # #
# #   #   # #   #     #   # #   # #       #     # #   #   #   #
##### ##### # # ##### # ### # ##### ####### # ### # # #########
#           # #   #   # #   # #     #       #   #   # # #     #
# ########### ### # ### # ### # ##### ############### # # ### #
#     #   #     #   #     #   #       #         #     #   #   #
##### # # ### # ### # ############# ##### ##### # # ####### # #
#   #   # #   # # # # #       #   #     # #   #   # #     # # #
# ####### # ### # # # # ### # # # ##### # ### # ##### ### # # #
#           #   #   #   #   #   #       #     #       #     # #
############################################################# #
